1111111111111111111111111111111111
1000010001000000000000000000000001
10E1000100011101111111111000011101
11111111111000001100100000001C1001
1000P00000000000000000111000110011
1111111111111111111111111111111111